        1111111111111111111111111
111111111000000001222222202222221
        1011000001000220000000021
        1001000001000220000000021
111111111011000010000220000000021
100000000000000101000000000111111
10000000000000001000000000001
10000011111110000000000000001
1100001     10000000000000001
10000011111110000000000000001
1000000000000000000000N000001
10000001110000011100000000011
10000001 1000001 101000000001
11111111 1111111 111111111111