R 2550 1080


C 005,30,0

NO ./path_to_the_north_texture
SO ./path_to_the_south_texture
WE ./path_to_the_west_texture
EA ./path_to_the_east_texture
S ./path_to_the_sprite_texture
F 000,100,0







1111111111111111111111111111111111111
11111100000000000000000000000000000001
1000000000000000000000000000000000001
1000000000000000000000000000000000001
10000000000000000000000W0000000000001
1000000000E00000000000000000000000001
1000000000000000000000000000000000001
10000000000000000000000000000000000N1
1000000000000000000000000000000000001
1000000000000000000100000000000000001
1111111111111111111111111111111111111